WWWWWWWWWWWWWWWWWWWWWWWWWWWWWWWWWWWWWWWWWWWWWWWWWWWWWWWWWWWW
WGGGGGGGGGGGGGGGGGGGGG                GGGGGGGGGGGGGGGGGGGGGW
WGGGGGGGGGGGGGGGGGGG                    GGGGGGGGGGGGGGGGGGGW
WGGGGGGGGGGGGGGGG                         GGGGGGGGGGGGGGGGGW
WGGGGGGGGGGGGGGGG            E            GGGGGGGGGGGGGGGGGW
WGGGGGGGGGGGGGGGG                         GGGGGGGGGGGGGGGGGW
WGGGGGGGGGGGGGGGGGG                     GGGGGGGGGGGGGGGGGGGW
WGGGGGGGGGGGGGGGGGGGG                 GGGGGGGGGGGGGGGGGGGGGW
W     WWWWWWWWWWWWWWWWWWWWWWWWWWWWWWWWWWWWWWWWWWWWWWWW     W
W             GGGGGGGGGGGGGGGGGGGGGGGGGGGGGGGG             W
W                GGGGGGGGGGGGGGGGGGGGGGGGGG                W
W                   GGGGGG        GGGGGG                   W
W                  GGGGGG          GGGGGG                  W
W                 GGGGGG            GGGGGG                 W
W                GGGGGG              GGGGGG                W
W               GGGGGG                GGGGGG               W
W              GGGGGG                  GGGGGG              W
W             GGGGGG                    GGGGGG             W
W            GGGGGG                      GGGGGG            W
W           GGGGGG                        GGGGGG           W
W          GGGGGG                          GGGGGG          W
WWWWWWWWWWWWWWWWWWWWWWWWW         WWWWWWWWWWWWWWWWWWWWWWWWWW
W                                                          W
WGGG                  GGGGGGGGGGGGGGG                   GGGW
WGGGGG                  GGGGGGGGGGG                   GGGGGW
WGGGGGGG                  GGGGGGG                   GGGGGGGW
WGGGGGGGGG                                        GGGGGGGGGW
WGGGGGGGGGGG                 J                  GGGGGGGGGGGW
WGGGGGGGGGGGGG                                GGGGGGGGGGGGGW
WWWWWWWWWWWWWWWWWWWWWWWWWWWWWWWWWWWWWWWWWWWWWWWWWWWWWWWWWWWW