WWWWWWWWWWWWWWWWWWWWWWWWWWWWWWWWWWWWWWWWWWWWWWWWWWWWWWWWWWWW
WGGGGGGGW                                          WGGGGGGGW
WG     GW                                          WG     GW
WG                  GGGGGGGGGGGGGGGGGGGGG                 GW
WG  E            GGGGGGGGGGGGGGGGGGGGGGGGGGG           E  GW
WG                  GGGGGGGGGGGGGGGGGGGGG                 GW
WG     GW                                          WG     GW
WGGGGGGGW                                          WGGGGGGGW
WWWWWWWWW                                          WWWWWWWWW
W                         GW     WG                        W
W        GGGGGGGGGG       GW     WG       GGGGGGGGGG       W
W         GGGGGGGG        GW     WG        GGGGGGGG        W
W        GGGGGGGGGG       GW     WG       GGGGGGGGGG       W
W                         GW     WG                        W
W                         GW     WG                        W
W        GGGGGGGGGG       GW     WG       GGGGGGGGGG       W
W         GGGGGGGG        GW     WG        GGGGGGGG        W
W        GGGGGGGGGG       GW     WG       GGGGGGGGGG       W
W                         GW     WG                        W
W                         GW     WG                        W
W        GGGGGGGGGG       GW     WG       GGGGGGGGGG       W
W         GGGGGGGG        GW     WG        GGGGGGGG        W
W        GGGGGGGGGG       GW     WG       GGGGGGGGGG       W
W                         GW     WG                        W
W                         GW     WG                        W
W        GGGGGGGGGG                       GGGGGGGGGG       W
W         GGGGGGGG            J            GGGGGGGG        W
W        GGGGGGGGGG                       GGGGGGGGGG       W
W                                                          W
WWWWWWWWWWWWWWWWWWWWWWWWWWWWWWWWWWWWWWWWWWWWWWWWWWWWWWWWWWWW