WWWWWWWWWWWWWWWWWWWWWWWWWWWWWWWWWWWWWWWWWWWWWWWWWWWWWWWWWWWW
WGGGGGGGGGGGGGGGGGGGGGGGGGGGGGGGGGGGGGGGGGGGGGGGGGGGGGGGGGGW
WG                           E                            GW
WG                                                        GW
WG   GGGGGGGGGGGG       GGGG    GGGG       GGGGGGGGGGGG   GW
WG   GGGGGGGGGGGG       GGGGG   GGGG       GGGGGGGGGGGG   GW
WG       GGGG           GGGGG   GGGG       GGGG           GW
WG       GGGG           GGGGGG  GGGG       GGGG           GW
WG       GGGG           GGGGGGG GGGG       GGGG           GW
WG       GGGG           GGGG GG GGGG       GGGGGGGG       GW
WG       GGGG           GGGG GG GGGG       GGGGGGGG       GW
WG       GGGG           GGGG  GGGGGG       GGGG           GW
WG       GGGG           GGGG  GGGGGG       GGGG           GW
WG       GGGG           GGGG   GGGGG       GGGG           GW
WG   GGGGGGGGGGGG       GGGG   GGGGG       GGGG           GW
WG   GGGGGGGGGGGG       GGGG    GGGG       GGGG           GW
WG                                                        GW
WG                                                        GW
WG                                                        GW
WG    G     G   GGGGGGG   GGGGGGG    GGGGGG   SGGGGGG     GW
WG    G     G   G         G     G   GG        G           GW
WG    G     G   G         G     G   G         GG          GW
WG    G     G   GGGGG     GGGGG     G   GGG    GGGGG      GW
WG    G     G   G         G  GG     G     G        GG     GW
WG    GG   GG   G         G   GG    GG   GG         G     GW
WG     GGGGG    G         G    GG    GGGGG    GGGGGGG     GW
WG                                                        GW
WG                           J                            GW
WGGGGGGGGGGGGGGGGGGGGGGGGGGGGGGGGGGGGGGGGGGGGGGGGGGGGGGGGGGW
WWWWWWWWWWWWWWWWWWWWWWWWWWWWWWWWWWWWWWWWWWWWWWWWWWWWWWWWWWWW