WWWWWWWWWWWWWWWWWWWWWWWWWWWWWWWWWWWWWWWWWWWWWWWWWWWWWWWWWWWW
W          GGGGGGGGGGGGGGGGGGGGGGGGGGGGGGGGGGGGGGGGGGGGGGGGW
W             GGGGGGGGGGGGGGGGGGGGGGGGGGGGGGGGGGGGGGGGGGGGGW
W    E                         GGGGGGGGGGGGGGGGGGGGGGGGGGGGW
W                                      GGGGGGGGGGGGGGGGGGGGW
W                                                 GGGGGGGGGW
WWWWWWWWWWWWWWWWWWWWWWWWWWWWWW                        GGGGGW
WGGGGGGGGGGGGGGGGGGGGGGGG                             GGGGGW
WGGGGGGGGGGGGGGGGGGGGG                                 GGGGW
WGGGGGGGGGGGGGGGG                                      GGGGW
WGGGGGGGGGGGGG                                        GGGGGW
WGGGGGGGGGG                                          GGGGGGW
WGGGGGGG                     G                     GGGGGGGGW
WGGGG                       GGGG                  GGGGGGGGGW
WGG                       GGGGGGGGGGG           GGGGGGGGGGGW
W                         WWWWWWWWWWWWWWWWWWWWWWWWWWWWWWWWWW
W                                                 GGGGGGGGGW
W                                                    GGGGGGW
WGGG                                                   GGGGW
WGGGG                                                   GGGW
WGGGGGG                                                   GW
WGGGGGGG                                                   W
WGGGG                                                      W
WGG                                                J       W
W                                                          W
WGGGGG               GGGGGGGGGGGGGGGGGGG                   W
WGGG              GGGGGGGGGGGGGGGGGGGGGGGG             GGGGW
WGG                    GGGGGGGGGGGGGGGG              GGGGGGW
W                                                GGGGGGGGGGW
WWWWWWWWWWWWWWWWWWWWWWWWWWWWWWWWWWWWWWWWWWWWWWWWWWWWWWWWWWWW